กปิตถา		กรมหมื่นภูบาลบริรักษ์
กมลาศน์		กรมหมื่นราชศักดิ์สโมสร
กฤดากร		กรมพระนเรศวรฤทธิ์
กล้วยไม้		กรมหมื่นสุนทรธิบดี
กัลยาณะวงศ์		กรมหมื่นกวีพจนสุปรีชา
กาญจนะวิชัย		กรมหมื่นชาญชัยบวรยศ
กำภู		พระองค์เจ้าชายกำภู
กิติยากร		กรมพระจันทบุรีนฤนาถ
กุญชร		กรมพระพิทักษ์เทเวศร์
กุสุมา		กรมหมื่นเทพสุนทร
เกษมศรี		กรมหมื่นทิวากรวงศ์ประวัติ
เกษมสันต์		กรมหลวงพรหมวรานุรักษ์
เกสะรา		กรมหมื่นอานุภาพพิศาลศักดิ์
โกเมน		กรมหมื่นเชษฐาธิเบนทร์
ค.นจร		กรมหมื่นอมเรนทรบดินทร์
คัคณางค์		กรมหลวงพิชิตปรีชากร
งอนรถ		พระองค์ชายงอนรถ
จรูญโรจน์		กรมหมื่นจรัสพรปฏิภาณ
จักรพงศ์		สมเด็จเจ้าฟ้า ฯ กรมหลวงพิษณุโลกประชานาถ
จักรพันธุ์		สมเด็จเจ้าฟ้า ฯ กรมพระจักรพรรค์พงศ์
จันทรหัต		กรมหมื่นวิวิธวรรณปรีชา
จิตรพงศ์		สมเด็จเจ้าฟ้า ฯ กรมพระยานริสรานุวัตติวงศ์
จิรประวัติ		กรมหลวงนครไชยศรีสุรเดช
จุฑาธุช		สมเด็จเจ้าฟ้า ฯ กรมขุนเพ็ชรบูรณ์อินทราชัย
เจษฎางกูร		เจ้าฟ้ากรมหลวงจักรเจษฎา
ฉัตรกุล		กรมหมื่นสุรินทรรักษ์
ฉัตรชัย		กรมพระกำแพงเพ็ชรอัครโยธิน
ชมพูนุท		กรมขุนเจริญผลพูลสวัสดิ์
ชยางกูร		กรมหมื่นพงษาดิศรมหิป
ชุมพล		กรมหลวงสรรพสิทธิประสงค์
ชุมสาย		กรมขุนราชสีหวิกรม
ชุมแสง		กรมหลวงสรรพศิลป์ปรีชา
ไชยันต		กรมหมื่นมหิศรราชหฤทัย
ดวงจักร		กรมหมื่นณรงค์หริรักษ์
ดารากร		กรมหมื่นศรีสุเทพ
ดิศกุล		สมเด็จ ฯ กรมพระยาดำรงราชานุภาพ
เดชาติวงศ์		กรมสมเด็จพระเดชาดิศร
โตษะณีย์		พระองค์เจ้าชายโตสินี
ทวีวงศ์		กรมหมื่นภูธเรศธำรงศักดิ์
ทองแถม		กรมหลวงสรรพสาตรศุภกิจ
ทองใหญ่		กรมหลวงประจักษ์ศิลปาคม
ทัพพะกุล		กรมหมื่นจิตรภักดี
ทินกร		กรมหลวงภูวเนตรนรินทรฤทธิ์
เทพหัสดิน		เจ้าฟ้ากรมหลวงเทพหริรักษ์
เทวกุล		สมเด็จ ฯ กรมพระยาเทวะวงศ์วโรปการ
นพวงษ์		กรมหมื่นมเหศวรศิววิลาศ
นรินทรกุล		กรมหลวงนรินทรเทวี
นรินทรางกูร		เจ้าฟ้ากรมหลวงนรินทร์รณเรศ
นวรัตน์		กรมหมื่นสถิตยธำรงสวัสดิ์
นันทวัน		พระองค์เจ้าชายนันทวัน
นันทิศักดิ์		พระองค์เจ้าชายเริงคนอง
นิยมีศร		พระองค์เจ้าชายเนียม
นิลรัตน		กรมหมื่นอลงกฎกิจปรีชา
นีรสิงห		พระองค์เจ้าชายเณร
บรรยงกะเสนา		กรมขุนธิเบศร์บวร
บริพัตร		สมเด็จเจ้าฟ้า ฯ กรมพระนครสวรรค์วรพินิต
ประวิตร		กรมหลวงปราจิณกิติบดี
ปราโมช		กรมขุนวรจักรธรานุภาพ
ปัทมสิงห		พระองค์เจ้าชายบัว
ปาลกะวงศ์		กรมหมื่นนราเทเวศร์
ปิยากร		พระองค์เจ้าชายเปียก
พนมวัน		กรมพระพิพิธโภคภูเบนทร์
พยัคฆเสนา		พระองค์เจ้าชายเสือ
พรหม		พระองค์เจ้าชายพรหมเมศ
พึ่งบุญ		กรมหลวงรักษ์รณเรศ
เพ็ญพัฒน		กรมหมื่นพิไชยมหินทโรดม
ไพทูรย์		กรมหมื่นสนิทนเรนทร์
ภาณุพันธุ์		สมเด็จเจ้าฟ้า ฯ กรมพระยาภาณุพันธุวงศ์วรเดช
ภาณุมาศ		พระองค์เจ้าชายภาณุมาศ
ภุมรินทร		พระองค์เจ้าชายภุมริน
มนตรีกุล		เจ้าฟ้ากรมหลวงพิทักษมนตรี
มรกฎ		กรมขุนสถิตย์สถาพร
มหากุล		กรมหลวงมหิศวรินทรามเรศร์
มหิดล		สมเด็จเจ้าฟ้า ฯ กรมหลวงสงขลานครินทร์
มาลากุล		สมเด็จเจ้าฟ้า ฯ กรมพระยาบำราบปรปักษ์
ยุคนธรานนท์		พระองค์เจ้าชายยุคนธร
ยุคันธร		กรมหมื่นอนันตการฤทธิ์
ยุคล		สมเด็จเจ้าฟ้า ฯ กรมหลวงลพบุรีราเมศร์
รพีพัฒน		กรมหลวงราชบุรีดิเรกฤทธิ์
รองทอง		กรมหมื่นสิทธิสุขุมการ
รังสิต		สมเด็จ ฯ กรมพระยาชัยนาทนเรนทร
รังสิเสนา		พระองค์เจ้าชายโย
รัชนิกร		พระองค์เจ้าชายรัชนิกร
รัชนี		กรมหมื่นพิทยาลงกรณ์
รุจะวิชัย		พระองค์เจ้าชายรุจาวรฉวี
เรณุนันทน์		พระองค์เจ้าชายเรณู
ลดาวัลย์		กรมหมื่นภูมินทรศักดี
ลำยอง		พระองค์เจ้าชายลำยอง
วรรัตน		กรมหมื่นพิศาลบวรภักดิ์
วรวรรณ		กรมพระนราธิปประพันธ์พงศ์
วรวุฒิ		พระองค์เจ้าชายวรวุฒิอาภรณ์
วัชรีวงศ์		กรมพระเทเวศร์วัชรินทร์
วัฒนวงศ์		กรมขุนมรุพงศ์สิริพัฒน์
วิบูลยพรรณ		พระองค์เจ้าชายวิบูลยพรรณรังษี
วิสุทธิ์		พระองค์เจ้าชายบวรวิสุทธิ์
วุฒิชัย		กรมหลวงสิงหวิกรมเกรียงไกร
ศรีธวัช		กรมขุนสิริธัชสังกาศ
ศิริวงศ์		สมเด็จพระบรมราชมาตามหัยกาเธอ กรมหมื่นมาตยาพิทักษ์
ศุขสวัสดิ์		กรมหลวงอดิศรอุดมเดช
โศภางค์		พระองค์เจ้าชายศรีเสาวภางค์
สนิทวงษ์		กรมหลวงวงศาธิราชสนิท
สวัสดิกุล		กรมพระสมมตอมรพันธุ์
สวัสดิวัตน์		สมเด็จ ฯ กรมพระสวัสดิวัตนวิศิษฐ์
สหาวุธ		พระองค์เจ้าชายชุมแสง
สังขทัต		กรมขุนนรานุชิต
สายสนั่น		พระองค์เจ้าชายสนั่น
สิงหรา		กรมหลวงบดินทรไพศาลโสภณ
สีสังข์		พระองค์เจ้าชายสีสังข์
สุทัศน์		กรมหมื่นไกรสรวิชิต
สุทัศนีย์		พระองค์เจ้าชายสุทัศนนิภาธร
สุธารส		พระองค์เจ้าชายสุธารส
สุนทรกุล ณ ชลบุรี		กรมขุนสุนทรภูเบศร์
สุบรรณ		กรมขุนภูวนัยนฤเบนทราธิบาล
สุประดิษฐ		กรมหมื่นวิษณุถนิภาธร
สุริยกุล		กรมพระรามอิศเรศ
สุริยง		กรมหมื่นไชยาศรีสุริโยภาส
เสนีวงศ์		กรมหมื่นเสนีบริรักษ์
โสณกุล		กรมขุนพิทยลาภพฤฒิธาดา
หัสดินทร		กรมหมื่นบริรักษ์นรินทรฤทธิ์
อนุชะศักดิ์		พระองค์เจ้าชายนุช
อรณพ		กรมหมื่นอุดมรัตนราษี
อรุณวงษ์		กรมหลวงวรศักดาพิศาล
อสุนี		กรมหมื่นเสนีเทพ
อาภรณกุล		เจ้าฟ้าชายอาภรณ์
อาภากร		กรมหลวงชุมพรเขตรอุดมศักดิ์
อินทรางกูร		กรมหมื่นอินทรพิพิธ
อิศระศักดิ์		เจ้าฟ้าอิศราพงษ์
อิศรเสนา		กรมหมื่นกษัตริย์ศรีศักดิ์เดช
อิศรางกูร		เจ้าฟ้ากรมขุนดิศรานุรักษ์
อุไรพงศ์		กรมหมื่นอดุลยลักษณสมบัติ
